0000000606
6000606606
0606060606
0060006000
9006060664
0000606066
0606060060
6060006000
0000060000
0000006000