0000000000
0000000000
6666660000
0000066660
9555500066
0000555554
6666600066
0660000060
0600000000
0000000000