0555050554
0555555555
0555000555
0050666050
0550696055
0050666050
0555000555
0555555555
0555050555
0000000000