9600000000
0606060606
0060006006
6006606060
0600600006
0060606060
0600060606
0000606000
0060066660
0000000064