9000000653
0000000666
0000000006
5500000000
3500225220
5500202020
6002524252
6660202020
0006225220
0060000000