9000000003
0222222223
0000006000
5222222222
0000000000
2222222226
0000000000
0222222225
0600000023
2222222264