9053206003
0060006600
0000000666
0000006003
2222222252
0600277777
6060277005
0606200060
0660200060
3006200664