3050055600
0500060060
5000000200
0000002222
0000922422
0000002222
0000000200
6666000000
0006000055
0606000553