0060005554
0000005555
0060005555
0000005555
0060600600
0000060060
0060000600
0060060060
0000000600
9000000000