0000000000
0000000000
0000000000
0000006000
0000060600
0000606060
9006064606
0000606060
0000060600
0000006000
