0000000000
0000000000
0000000000
0000000000
0000222000
9030242000
0000222000
0000000000
0000000000
0000000000