0000000000
0000000000
0000000000
0000000006
9000000064
0000000006
0000000000
0000000000
0000000000
0000000000