0000333300
0202902020
0200202020
0200202020
0200202020
0200222020
0222222020
0222422220
0000000000
0000000000