9000000003
0000000006
0000060000
0000000000
0006000000
0000000000
0666022222
6000625555
0606625555
3000025554