0000000000
0000000000
0000000000
0000000000
9060000000
0000000000
0000000000
0000000050
0000000545
0000000050