0050055055
0650505054
0050050050
0650565050
9050055050
0650505650
0050050050
0050505055
0056055050
0050505055