3500000060
5500000606
0000000630
0000707766
0000090000
2000707000
2222000766
2222000536
2222006666
4222200053