9000000000
0000022222
0000200420
0002200200
0000022000
0000020606
0000066660
0006606600
0000066000
0000600653