0505600504
5050505650
0560056505
5056565050
0565000505
5650565050
6565050505
5656565050
6065650505
9650505050